Peñes,Columnas Locas,Atrapa el banderín,Cuerda y coraje,Encesta y Escapa,La Muerte,Total
Otra peña 6,9,9,0,0,0,18
Otra peña 15,10,5,0,0,0,15
Otra peña 14,9,6,0,0,0,15
NPM,10,3,0,0,0,13
Otra peña 13,8,4,0,0,0,12
Otra peña 1,2,9,0,0,0,11
Otra peña 11,5,5,0,0,0,10
Otra peña 8,3,7,0,0,0,10
Otra peña 9,2,8,0,0,0,10
Otra peña 12,7,2,0,0,0,9
Otra peña 2,1,8,0,0,0,9
Otra peña 5,3,5,0,0,0,8
Otra peña 7,4,3,0,0,0,7
Otra peña 3,5,1,0,0,0,6
Otra peña 4,2,0,0,0,0,2
Otra peña 10,1,1,0,0,0,2
